NO ./textures/SONIC.xpm
SO ./textures/SONIC.xpm
WE ./textures/SONIC.xpm
EA ./textures/SONIC.xpm

F 52,162,3
C 0,33,243

111111111111111111111
1000000000N1000000001
100000000001000000001
100000000010000000011
100000000001000000001
100000000001000000001
111111111111111111111