NO ./textures/note-128.xpm
SO ./textures/note-128.xpm
WE ./textures/note.xpm




EA ./textures/note.xpm

F 150,200,255
C 15,200,0

      111111
11111110000111111111111111111111111111111111111111111111111111111111111111111111111111111
10000000E000000000000000000000000000000000000000000000000000000000000000000000111111111111111
111000000000000000100000000000000000000000000000000000000000000000000000000000000000111
1E00000000000000000000000000000000000000000000000000000000000000000000000000000111111111111111
11111111111111111111111111111111111111111111111111111111111111111111111111111111111111111111
1          1
111111111111