NO ./textures/texture.xpm
WE ./textures/texture.xpm
EA ./textures/texture.xpm
SO ./textures/texture.xpm

F 220,100,0
C 225,30,0










111111111111111
100000000000001
100000010000001
100000000000001
10N010010010001
100000000000001
100000010000001
100000000000001
111111111111111