NO ./textures/texture.xpm
WE ./textures/note-128.xpm
EA ./textures/ZER.xpm
SO ./textures/texture.xpm

F 220,250,0
C 225,30,0





















11111111111111111111111111111
10000000000000100000000000001
10000001000000100000010000001
10000000000000100000000000001
10N01001001001000100100100011
10000000000000100000000000001
10000001000000100000010000001
10000000000000100000000000001
11111111111111111111111111111