1111111
1P000C1
1111101
1C000E1
1111111
