111111
1P0C11
1C0001
1000E1
111111
